1111111111111111111111111111
1E0000000000000C00000C0000P1
1010010100100000101001000001
1010010010101010001001000001
1111111111111111111111111111
