11111111111111111
10P11N11NCN000011
100100C110001N011
1N0N0NN01010N0C01
11000NC010NE1N001
1101000N101010001
100N1N00000000NE1
11111111111111111